11111111111
1000000C001
11PE00C0001
10C00000001
11111111111
