11111111111
1000000C001
11PE00C0011
10C0000X111
11111111111
