1111111111
11C0111111
100E011111
10P1111111
1111111111
