11111111111
1100000C011
11111PE00C1
11C00000011
11111111111
