111111
100001
1PE001
10C001
111111
