11111111
11C01111
100E0111
11111111
10000001
1000P001
10000001
10000001
10000001
10000001
10000001
10000001
11111111
