11111111
11C01111
100E0111
10P11111
11111111
