11111111111
1000000C001
11111PE00C1
10C00000001
11111111111
