11111111111
1100000C111
1PE000000C1
11C00111111
11111111111
