11111111111
1000000C001
1PE001111C1
10C00111111
11111111111
