11111111
11CP1111
100E0111
11111111
10000001
10000001
10000001
10000001
10000001
10000001
10000001
10000001
10000001
11111111
